//MAP CONVERTED BY dmm2tgm.py THIS HEADER COMMENT PREVENTS RECONVERSION, DO NOT REMOVE
"bW" = (
/obj/structure/table/wood,
/obj/item/gun/ballistic/revolver/c38,
/turf/open/indestructible/hotelwood,
/area/deathmatch)
"fa" = (
/obj/machinery/light/warm/directional/east,
/turf/open/indestructible/hotelwood,
/area/deathmatch)
"fw" = (
/obj/machinery/door/airlock/wood,
/turf/open/indestructible/hotelwood,
/area/deathmatch)
"fT" = (
/obj/structure/tram/alt/wood{
	name = "wall"
	},
/turf/open/misc/beach/sand,
/area/deathmatch)
"gF" = (
/obj/item/gun/ballistic/rocketlauncher/unrestricted{
	pixel_x = -21;
	pixel_y = 0;
	name = "Legendary Bazooka"
	},
/obj/item/ammo_box/rocket{
	pixel_x = 11;
	pixel_y = -4
	},
/turf/open/misc/beach/sand,
/area/deathmatch/fullbright)
"gO" = (
/obj/structure/table/wood,
/obj/effect/spawner/random/contraband/grenades/lethal,
/obj/effect/spawner/random/contraband/grenades/dangerous,
/turf/open/indestructible/hotelwood,
/area/deathmatch)
"ic" = (
/turf/open/misc/sandy_dirt,
/area/deathmatch/fullbright)
"lq" = (
/obj/structure/chair/wood{
	dir = 4
	},
/turf/open/indestructible/hotelwood,
/area/deathmatch)
"of" = (
/obj/structure/table/wood,
/obj/item/kirbyplants/synthetic/plant28{
	pixel_x = 0;
	pixel_y = 12
	},
/turf/open/indestructible/hotelwood,
/area/deathmatch)
"os" = (
/obj/machinery/light/small/directional/north,
/obj/item/kirbyplants/random/dead,
/turf/open/indestructible/hotelwood,
/area/deathmatch)
"ti" = (
/obj/machinery/light/small/directional/east,
/turf/open/indestructible/hotelwood,
/area/deathmatch)
"tD" = (
/obj/structure/sacrificealtar,
/obj/effect/mob_spawn/corpse/human,
/obj/item/knife/ritual,
/obj/item/ritual_totem{
	pixel_x = 0;
	pixel_y = 32
	},
/turf/open/indestructible/hotelwood,
/area/deathmatch)
"tI" = (
/obj/structure/table/wood,
/obj/item/grenade/frag,
/turf/open/indestructible/hotelwood,
/area/deathmatch)
"tT" = (
/obj/machinery/light/small/directional/west,
/turf/open/indestructible/hotelwood,
/area/deathmatch)
"tY" = (
/obj/structure/table/wood,
/obj/item/storage/box/syndie_kit/chemical{
	pixel_x = 4;
	pixel_y = 1
	},
/obj/item/knife/poison{
	pixel_x = -3;
	pixel_y = 3
	},
/turf/open/indestructible/hotelwood,
/area/deathmatch)
"uS" = (
/obj/item/kirbyplants/random/dead,
/turf/open/indestructible/hotelwood,
/area/deathmatch)
"uV" = (
/obj/structure/fake_stairs/wood/directional/east,
/turf/open/indestructible/hotelwood,
/area/deathmatch)
"wm" = (
/obj/structure/rack{
	color = "#a85f16"
	},
/obj/structure/noticeboard/directional/north,
/obj/item/gun/ballistic/shotgun/lethal,
/turf/open/indestructible/hotelwood,
/area/deathmatch)
"wX" = (
/obj/structure/table/wood,
/obj/machinery/light/floor,
/turf/open/indestructible/hotelwood,
/area/deathmatch)
"xl" = (
/obj/structure/chair/wood,
/turf/open/indestructible/hotelwood,
/area/deathmatch)
"ya" = (
/obj/structure/reagent_dispensers/beerkeg,
/turf/open/indestructible/hotelwood,
/area/deathmatch)
"ys" = (
/obj/structure/table/wood/poker,
/obj/item/reagent_containers/cup/glass/bottle/amaretto{
	pixel_x = -6;
	pixel_y = 17
	},
/obj/item/reagent_containers/cup/glass/bottle/gin{
	pixel_x = 8;
	pixel_y = 19
	},
/obj/item/reagent_containers/cup/glass/bottle/wine_voltaic{
	pixel_x = 0;
	pixel_y = 10
	},
/turf/open/indestructible/hotelwood,
/area/deathmatch)
"yX" = (
/obj/effect/decal/cleanable/blood/footprints{
	color = "#612502";
	dir = 4;
	pixel_x = 16;
	pixel_y = -5
	},
/turf/open/misc/beach/sand,
/area/deathmatch/fullbright)
"zn" = (
/obj/structure/chair/wood,
/obj/effect/spawner/random/contraband/armory,
/turf/open/misc/beach/sand,
/area/deathmatch/fullbright)
"AD" = (
/obj/structure/chair/wood{
	dir = 1
	},
/obj/effect/landmark/deathmatch_player_spawn,
/turf/open/indestructible/hotelwood,
/area/deathmatch)
"AW" = (
/obj/effect/decal/cleanable/blood/footprints{
	color = "#612502";
	pixel_x = 0;
	pixel_y = -6
	},
/obj/machinery/door/airlock/wood{
	name = "сральник"
	},
/turf/open/misc/dirt/jungle/dark,
/area/deathmatch/fullbright)
"Bt" = (
/obj/structure/table/wood,
/obj/item/reagent_containers/cup/glass/drinkingglass/shotglass{
	pixel_x = -1;
	pixel_y = 3
	},
/obj/item/reagent_containers/cup/glass/bottle/beer/almost_empty{
	pixel_x = 10;
	pixel_y = 13
	},
/turf/open/indestructible/hotelwood,
/area/deathmatch)
"BF" = (
/turf/open/chasm/jungle,
/area/deathmatch/fullbright)
"Cb" = (
/obj/machinery/light/warm/directional/south,
/turf/open/indestructible/hotelwood,
/area/deathmatch)
"CS" = (
/obj/machinery/light/small/directional/north,
/turf/open/indestructible/hotelwood,
/area/deathmatch)
"Db" = (
/obj/structure/table/wood,
/obj/item/gun/ballistic/rifle/sks/chekhov{
	pixel_x = -25;
	pixel_y = 2
	},
/turf/open/indestructible/hotelwood,
/area/deathmatch)
"DJ" = (
/obj/structure/chair/wood{
	dir = 4
	},
/obj/effect/landmark/deathmatch_player_spawn,
/turf/open/indestructible/hotelwood,
/area/deathmatch)
"Ey" = (
/obj/structure/fake_stairs/wood/directional/east,
/obj/effect/landmark/deathmatch_player_spawn,
/turf/open/indestructible/hotelwood,
/area/deathmatch)
"GO" = (
/obj/machinery/light/small/red/directional/east,
/turf/open/indestructible/hotelwood,
/area/deathmatch)
"Hk" = (
/obj/structure/reagent_dispensers/fueltank/large,
/turf/open/indestructible/hotelwood,
/area/deathmatch)
"Hm" = (
/obj/item/food/grown/star_cactus,
/turf/open/misc/beach/sand,
/area/deathmatch/fullbright)
"Hy" = (
/obj/structure/chair/stool/bar/directional/north,
/turf/open/indestructible/hotelwood,
/area/deathmatch)
"IE" = (
/obj/effect/landmark/deathmatch_player_spawn,
/turf/open/misc/sandy_dirt,
/area/deathmatch/fullbright)
"IL" = (
/obj/machinery/light/warm/directional/west,
/turf/open/indestructible/hotelwood,
/area/deathmatch)
"Kd" = (
/turf/closed/wall/space,
/area/deathmatch/fullbright)
"Kp" = (
/obj/item/paper/crumpled{
	pixel_x = -9;
	pixel_y = 10
	},
/obj/structure/fluff/paper/stack{
	pixel_x = 11;
	pixel_y = 2
	},
/obj/effect/decal/cleanable/blood/gibs{
	pixel_x = 0;
	pixel_y = 18;
	color = "#612502"
	},
/obj/effect/decal/cleanable/blood/footprints{
	color = "#612502";
	pixel_x = 0;
	pixel_y = -15
	},
/obj/item/paper_bin{
	pixel_x = 32;
	pixel_y = 0
	},
/turf/open/misc/dirt/jungle,
/area/deathmatch/fullbright)
"Lu" = (
/obj/item/stack/medical/ointment{
	pixel_x = 9;
	pixel_y = 1
	},
/obj/structure/rack{
	color = "#a85f16"
	},
/obj/item/reagent_containers/spray/hercuri{
	pixel_x = -4;
	pixel_y = 10
	},
/obj/item/stack/medical/suture/medicated{
	pixel_x = 0;
	pixel_y = 1
	},
/turf/open/indestructible/hotelwood,
/area/deathmatch)
"Nl" = (
/obj/machinery/chem_dispenser/drinks/beer{
	pixel_x = 0;
	pixel_y = 7
	},
/obj/structure/table/wood,
/turf/open/indestructible/hotelwood,
/area/deathmatch)
"NW" = (
/turf/open/chasm/true/no_smooth/fake_motion_sand,
/area/deathmatch/fullbright)
"Op" = (
/obj/structure/table/wood,
/obj/item/reagent_containers/cup/glass/flask/gold{
	pixel_x = 5;
	pixel_y = 0
	},
/obj/item/reagent_containers/cup/glass/bottle/small{
	pixel_x = -9;
	pixel_y = 13
	},
/obj/item/gun/ballistic/revolver/reverse/mateba{
	pixel_x = -17;
	pixel_y = -2
	},
/turf/open/indestructible/hotelwood,
/area/deathmatch)
"Ph" = (
/obj/structure/rack{
	color = "#a85f16"
	},
/obj/item/ammo_casing/shotgun/dragonsbreath{
	pixel_x = 0;
	pixel_y = 5
	},
/obj/item/ammo_casing/shotgun/dragonsbreath{
	pixel_x = 0;
	pixel_y = 5
	},
/obj/item/ammo_casing/shotgun/buckshot{
	pixel_x = 7;
	pixel_y = 2
	},
/obj/item/ammo_casing/shotgun/buckshot{
	pixel_x = 7;
	pixel_y = 2
	},
/obj/item/ammo_casing/shotgun/stunslug{
	pixel_x = 0;
	pixel_y = 0
	},
/obj/item/ammo_casing/shotgun/stunslug{
	pixel_x = 0;
	pixel_y = 0
	},
/turf/open/indestructible/hotelwood,
/area/deathmatch)
"PP" = (
/obj/structure/table/wood/poker,
/obj/item/reagent_containers/cup/glass/bottle/cognac{
	pixel_x = 4;
	pixel_y = 18
	},
/obj/item/reagent_containers/cup/glass/bottle/fernet{
	pixel_x = -8;
	pixel_y = 19
	},
/obj/item/reagent_containers/cup/glass/bottle/navy_rum{
	pixel_x = -11;
	pixel_y = 8
	},
/obj/item/reagent_containers/cup/glass/bottle/kahlua{
	pixel_x = -1;
	pixel_y = 7
	},
/turf/open/indestructible/hotelwood,
/area/deathmatch)
"Qh" = (
/obj/effect/decal/cleanable/blood/footprints{
	color = "#612502";
	pixel_x = 0;
	pixel_y = 3
	},
/obj/effect/decal/cleanable/blood/footprints{
	color = "#612502";
	dir = 4;
	pixel_x = 22;
	pixel_y = -5
	},
/turf/open/misc/beach/sand,
/area/deathmatch/fullbright)
"Rx" = (
/turf/closed/indestructible/wood,
/area/deathmatch)
"RB" = (
/obj/structure/chair/stool/bar/directional/north,
/obj/effect/landmark/deathmatch_player_spawn,
/turf/open/indestructible/hotelwood,
/area/deathmatch)
"TA" = (
/turf/open/indestructible/hotelwood,
/area/deathmatch)
"TL" = (
/obj/structure/chair/wood{
	dir = 1
	},
/turf/open/indestructible/hotelwood,
/area/deathmatch)
"TZ" = (
/obj/structure/table/wood/poker,
/obj/item/reagent_containers/cup/glass/bottle/curacao{
	pixel_x = -11;
	pixel_y = 17
	},
/obj/item/reagent_containers/cup/glass/bottle/yuyake{
	pixel_x = 2;
	pixel_y = 20
	},
/obj/item/reagent_containers/cup/glass/bottle/applejack{
	pixel_x = 13;
	pixel_y = 19
	},
/obj/item/reagent_containers/cup/glass/bottle/vermouth{
	pixel_x = -18;
	pixel_y = 7
	},
/obj/item/reagent_containers/cup/glass/bottle/vodka{
	pixel_x = -4;
	pixel_y = 10
	},
/obj/item/reagent_containers/cup/glass/bottle/rum/aged{
	pixel_x = 9;
	pixel_y = 10
	},
/obj/machinery/light/warm/directional/north,
/turf/open/indestructible/hotelwood,
/area/deathmatch)
"Ua" = (
/obj/machinery/light/small/red/dim/directional/west,
/obj/structure/guncase/shotgun,
/obj/item/gun/ballistic/shotgun/bulldog,
/turf/open/indestructible/hotelwood,
/area/deathmatch)
"Vr" = (
/obj/effect/landmark/deathmatch_player_spawn,
/turf/open/indestructible/hotelwood,
/area/deathmatch)
"Wl" = (
/obj/structure/chair/wood{
	dir = 8
	},
/turf/open/indestructible/hotelwood,
/area/deathmatch)
"WD" = (
/turf/open/misc/beach/sand,
/area/deathmatch/fullbright)
"WU" = (
/turf/closed/indestructible/wood,
/area/deathmatch/fullbright)
"Yb" = (
/obj/structure/chair/wood,
/obj/effect/landmark/deathmatch_player_spawn,
/turf/open/indestructible/hotelwood,
/area/deathmatch)
"ZC" = (
/obj/structure/table/wood,
/turf/open/indestructible/hotelwood,
/area/deathmatch)

(1,1,1) = {"
Kd
Kd
Kd
Kd
Kd
Kd
Kd
Kd
Kd
Kd
Kd
Kd
Kd
Kd
Kd
Kd
Kd
Kd
Kd
Kd
Kd
Kd
Kd
Kd
Kd
"}
(2,1,1) = {"
Kd
NW
NW
NW
NW
NW
NW
NW
NW
NW
NW
NW
NW
NW
NW
NW
NW
NW
NW
NW
NW
NW
NW
NW
Kd
"}
(3,1,1) = {"
Kd
NW
WD
WD
WD
WD
WD
WD
WD
WD
WD
WD
WD
WD
WD
WD
WD
WD
WD
WD
WD
WD
WD
NW
Kd
"}
(4,1,1) = {"
Kd
NW
WD
WD
WD
WD
Hm
WD
WD
WD
WD
WD
WD
WD
WD
WD
WD
WD
WD
WD
Hm
WD
WD
NW
Kd
"}
(5,1,1) = {"
Kd
NW
WD
WD
WD
WD
WD
WD
WD
WD
WD
WD
Hm
WD
WD
WD
WD
WD
WD
WD
WD
WD
WD
NW
Kd
"}
(6,1,1) = {"
Kd
NW
WD
WD
WD
WD
WD
WD
WD
Rx
Rx
Rx
Rx
Rx
Rx
Rx
Rx
WD
WD
WD
WD
WD
WD
NW
Kd
"}
(7,1,1) = {"
Kd
NW
WD
WD
Rx
Rx
Rx
Rx
Rx
Rx
TA
TA
IL
TA
TA
TA
Rx
Rx
WD
WD
WD
WD
WD
NW
Kd
"}
(8,1,1) = {"
Kd
NW
Hm
Rx
Rx
ya
tT
Rx
os
TA
TA
DJ
TA
TA
TA
TA
TA
Rx
WD
WD
WD
WD
Hm
NW
Kd
"}
(9,1,1) = {"
Kd
NW
WD
Rx
Nl
TA
TA
ZC
Hy
TA
xl
tI
TL
TA
lq
TA
TA
Rx
WD
WD
WD
WD
WD
NW
Kd
"}
(10,1,1) = {"
Kd
NW
WD
Rx
Nl
Vr
TA
ZC
TA
TA
TA
Wl
TA
xl
tY
TL
Cb
Rx
WD
WD
WD
WD
WD
NW
Kd
"}
(11,1,1) = {"
Kd
NW
WD
Rx
ys
TA
TA
Op
RB
TA
TA
TA
TA
TA
Wl
TA
TA
Rx
WD
WD
WD
WD
WD
NW
Kd
"}
(12,1,1) = {"
Kd
NW
WD
fT
TZ
TA
TA
ZC
TA
TA
TA
lq
TA
TA
TA
TA
uS
Rx
WD
WD
WD
WD
WD
ic
Kd
"}
(13,1,1) = {"
Kd
NW
WD
fT
PP
TA
TA
Bt
Hy
TA
xl
wX
TL
TA
TA
TA
TA
fw
ic
ic
WD
ic
ic
ic
Kd
"}
(14,1,1) = {"
Kd
NW
gF
fT
wm
TA
TA
ZC
TA
TA
xl
Db
AD
TA
TA
TA
TA
fw
IE
ic
ic
ic
ic
ic
Kd
"}
(15,1,1) = {"
Kd
NW
WD
fT
Hk
TA
ti
of
Hy
TA
TA
Wl
TA
TA
TA
TA
uS
Rx
zn
WD
ic
ic
WD
WD
Kd
"}
(16,1,1) = {"
Kd
NW
WD
Rx
Rx
fw
Rx
Rx
CS
TA
TA
TA
TA
TA
lq
TA
TA
Rx
WD
WD
WD
WD
WD
NW
Kd
"}
(17,1,1) = {"
Kd
NW
WD
Rx
Ua
TA
Ph
Rx
TA
TA
TA
lq
TA
xl
gO
TL
Cb
Rx
WD
WD
WD
WD
WD
NW
Kd
"}
(18,1,1) = {"
Kd
NW
WD
Rx
tD
Vr
TA
fw
TA
TA
Yb
bW
TL
TA
Wl
TA
TA
Rx
WD
WD
WD
WD
WD
NW
Kd
"}
(19,1,1) = {"
Kd
NW
WD
Rx
Rx
GO
Lu
Rx
uS
TA
TA
Wl
TA
TA
TA
TA
TA
Rx
WD
Hm
WD
WD
WD
NW
Kd
"}
(20,1,1) = {"
Kd
NW
WD
WD
Rx
Rx
Rx
Rx
Rx
Rx
TA
TA
fa
TA
TA
TA
Rx
Rx
WD
WD
WD
WD
WD
NW
Kd
"}
(21,1,1) = {"
Kd
NW
WD
WD
WD
WD
WD
WD
WD
Rx
Rx
Rx
Rx
uV
Ey
uV
Rx
WD
WD
WD
WD
WD
WD
NW
Kd
"}
(22,1,1) = {"
Kd
NW
WD
WD
WD
WD
WD
WD
WD
WD
WD
WD
Rx
Rx
Rx
Rx
Rx
WD
WD
WD
WD
WD
WD
NW
Kd
"}
(23,1,1) = {"
Kd
NW
WD
WD
Hm
WD
WD
WD
WD
WD
WD
WD
WD
WD
WD
WD
WD
WD
WD
WD
WD
Hm
WD
NW
Kd
"}
(24,1,1) = {"
Kd
NW
WD
WD
WD
WD
WD
WD
WD
WD
WD
WU
WU
WU
WU
WD
WD
WD
WD
WD
WD
WD
WD
NW
Kd
"}
(25,1,1) = {"
Kd
NW
WD
WD
WD
WD
WD
WD
WD
Hm
WD
WU
BF
Kp
AW
Qh
WD
WD
WD
WD
WD
WD
WD
NW
Kd
"}
(26,1,1) = {"
Kd
NW
NW
NW
NW
NW
NW
NW
NW
NW
NW
WU
WU
WU
WU
yX
WD
WD
Hm
WD
WD
WD
WD
NW
Kd
"}
(27,1,1) = {"
Kd
Kd
Kd
Kd
Kd
Kd
Kd
Kd
Kd
Kd
Kd
Kd
Kd
Kd
Kd
Kd
Kd
Kd
Kd
Kd
Kd
Kd
Kd
Kd
Kd
"}
